-A: 打印每个包, 一般用于捕捉web 页面
-b: 打印AS号在BGP包中使用ASDOT格式而不是ASPLAIN格式
-B: 设置操作系统的buffer_size
-c: 接收指定个数
-C：保存raw包到指定格式时, 检测当前文件是否大于文件的大小
-d: 以人类可读的方法, 输出收集到的数据包
-dd: 以C程序的格式输出收集到的数据包
-ddd: 以十进制的格式输出收集到的数据包
-D: 打印当前系统的网络接口的列表, 可以通过 -i 选项, 指定 监听接口
-e: 打印每行数据的  链路层 的头部信息
-E: 指定spi@ipaddr algo:secret 为IPSEC ESP格式的解密数据
-f: 打印 ip地址,
-F: 指定输入的 过滤表达式 的文件, 忽略命令行参数
-G: rotate 输出的文件 根据指定的时间(-w )
-H: 尝试检测 802.11s头
-I: 指定监听模式, 仅仅支持 802.11 的WIFI网卡
-j: 设置时间戳格式
-J: 列出网卡支持的时间戳格式
--time-stamp-precision=  ：指定时间戳精度
-K: 不检测IP, TCP, UDP的 chuecksums
-l: 缓存 输出行,  tcpdump -l | tee bat , 
-m:  加载 SMI mib库
-M: 使用 密码作为 tcp段的共享密码
-n:  不进行DNS解析
-nn:  不解析 协议和端口
-N:   不打印域名后缀
-O:  不允许优化的 包匹配
-p: 网卡 不使用混杂模式
-P: 指定 流量 流向 in,out, inout
-q: 快速输出, 打印最少的网络协议信息
-r：读取 包文件
-S: 打印觉得的tcp队列, 而不是相对的
-T:
-t: 每行 不打印时间戳
-tt: 打印未知格式的时间戳每行
-v： 详细输出
-vv: 更详细的输出
-vvv: 最详细输出

